1111111111111111111111111111111111
1000000000000000000000000000000001
10P00000000000000000000000C0000001
1000010000000000000000000000000001
10001C1000000000000000000000000001
1000010000000000000000000000001011
1000000000000000000000000000001011
1000000000000000000000000000001011
100000000C000000000000000000001011
1000000000000000000000000000001011
1000000000000000000000000000001011
1000000000000000000000000000001011
1000000000000000000C00000000001011
1000000000000000000000000000001011
1000000000000000000000000000001011
10000000000000000000000000000C1011
1000001110000000000000000000001011
1000001C10000000000000000000001E11
1000000010000000000000000000001001
1111111111111111111111111111111111